0000000000000000000000000000000000
0000000000000000000000000000000000
0000000000000000000000000000000000
0000000000000000000000000000000000
0000000222220000000000000000000000
0000000000000000000000000000000000
2200000000000000022000000220000000
1122222222222222211000022112000220
1111111111111111111000011111000110
1111111111111111111000001100000000
1111111111111111111000001000000000
1111111111111111111000001000000000
1111111111111111111000000000000000